4 4 4 4 4 4 4 0 0 4 4 4 4 4 4 4
4 11 6 6 6 6 6 6 6 6 6 6 6 10 4 4
4 9 5 5 5 5 5 5 5 5 5 5 5 8 4 4
4 9 5 5 5 5 5 5 5 5 5 5 5 8 4 4
3 9 5 5 5 5 5 5 5 5 5 5 5 8 1 4
3 9 5 5 5 5 5 5 5 5 5 5 5 8 1 4
4 9 5 5 5 5 5 5 5 5 5 5 5 8 4 4
4 9 5 5 5 5 5 5 5 5 5 5 5 8 4 4
4 13 7 7 7 7 7 7 7 7 7 7 7 12 4 4
4 4 4 4 4 4 4 2 2 4 4 4 4 4 4 4
4 4 4 4 4 4 4 4 4 4 4 4 4 4 4 4
